------------
-#*********-
-*--------*-
-*-******-*-
-*-*----*-*-
-*-*-**---*-
-*-******-*-
-*-*----*-*-
-*-****-*-*-
-*----*-*---
-******-**$-
------------