------------
-#*-***-***-
-**-*-*-*-*-
-**-*-*-*-*-
-**-*-*-*-*-
-**-*-*-*-*-
-**-*-*-*-*-
-**-*-*-*-*-
-****-***-*-
-*--------*-
-*********$-
------------