******************-*****-***-***************-*****-*************-*******************-*********************-***-***-*****-***
---------*---*-----*-*-*-*-*-*-----------*---*-*---*-----*-----*-*-------*-----*-----*-*-----------------*-*-*-*-*-*-*-*-*-*
****-***-***-*-*****-*-*-*-*-*******-***-***-*-*****-***-*****-*-*****-*-***-***-*****-***-*****-***-***-***-*-*-***-*-***-*
---*-*-*---*---*-----*-*---*-------*---*---*-*-------*-*-----*-*-----*-*---*-*---*-------*-*---*-*-*--$*-----*-*-----*-----*
**-***-***-*****-*****-*-*****-***-***-***-***-*******-*****-*-*****-*-***-*-*-***-*****-***-*-***-***-*****-*-***-*-***-***
-*-------*-----*-*-----*-*---*-*-----*-*-*-----*---------*---*-------*-*---*---*---*---*-----*-------*---*-*-*---*-*---*----
-*******-*****-*-*****-*-*-*****-*****-*-*******-***-***-***-***-*****-***-*****-***-*-*-***-*******-***-*-*-*-***-***-*-***
-------*-----*-------*-*-*-----*-*-----*---------*-*-*-*---*---*-*-------*---------*-*-*-*---*---*-*---*-*-*-*-*-----*-*-*-*
-*****-*****-*********-*-*-***-*-***-*-*-*****-***-*-*-***-***-*-*-*****-***********-*-***-***-***-***-*-*-***-*******-***-*
-*---------*-----------*-*-*-*-----*-*-*-*-*-*-*---*-*---*-*-*-*-*-*-*-*-*-----------*---*-*---*-------*-*-----*-----*-----*
-*-*******-***-*****-***-***-***-***-*-*-*-*-***-***-*-*-*-*-*-*-*-*-*-***-*****-*********-***-***-***-*-*-*****-***-*-***-*
-*-*-*-------*-*---*-*---------*-*---*-*---*-----*---*-*-*-*-*-*-*-*-*---*-*---*---------*---*---*-*-*-*---*-----*-*---*-*-*
-***-*****-***-***-*************-*-***-***-***-***-***-***-*-*-***-*-***-*-*-*-*-***-***-*-*****-*-*-***-***-***-*-***-*-*-*
---------*-*-*-----------------*-*-*-*---*---*---*-*---*---*-------*---*---*-*-*-*-*-*-*---*-----*-*-*---*---*---*---*-*-*-*
-*****-***-*-*-*****-*****-*****-*-*-***-***-***-***-*****-*-*****-*-***-***-*-***-*-*-*****-*****-*-*-***-***-***-*****-***
-*---*-*-*-*---*---*-*---*-------*-*-------*---*-----------*-*-*-*---*---*---*-----*-*-------*-----*---*---*-*-*------------
**-***-*-*-***-*-*-*-*-*-*********-*-***********-***-*****-*-*-*-***-*****-*****-***-*******-*****-*****-***-*-***-*****-***
---*---*-----*-*-*-*-*-*-----------*-*-----------*-*-*---*-*-*-*---*-*-------*---*-*-------*-----*---------*-*---*-*---*-*-*
**-*-***-*****-*-*-*-*-*************-*-***-*****-*-*-***-*-***-*-***-*-*******-***-*******-*-***-*-*********-***-*-***-***-*
-*-*-*---*-----*-*-*-*-*-------*-----*-*-*-*---*-*-*---*-*-----*-*---*---*---*-*-----*-----*---*-*-*-*---*-----*-*-*-------*
-*-*-***-*-***-***-*-*-***-***-*-***-***-*-***-***-*-***-***-***-*-*****-*-*-*-*-*****-***-*-***-***-*-***-***-*-***-*******
-*-*-*-*-*-*-*---*-*-*-----*-*-*-*-*---*-----*-----*-*-----*-*---*-----*-*-*-*-*-*-----*-*-*-*-*-----*-*---*-*-*-----*-----*
**-*-*-*-***-*****-***-*****-*-*-*-*****-***-*-*****-*-*******-*-*-***-***-***-*-*****-*-***-*-*-*****-***-*-*-*-*****-*****
---*---*---------------*-----*-*-*-----*-*-*-*-*-----*---------*-*-*-*-----*---*-------*-----*---*-*-------*-*-*-*-----*----
**-*********-***-*******-***-*-***-***-*-*-***-*****-*****-***-***-*-***-*****-*****-***-*****-***-*-*******-*-*-*-*-***-***
-*---------*-*-*-*-----*---*-*-----*-*---*---------*-----*-*-*-*---*---*-*---------*-*-------*-*-----*-------*-*-*-*-*-----*
-*-*******-***-*-*-***-***-*-*******-*****-*******-*******-*-*-*-***-***-*-*********-*-*******-*-*****-*****-*-*-*-*****-***
-*-*-----*-----*---*-*---*-*---------------*-----*---------*-*-*-*-*-*---*-*-------*-*-*---*---*-*---------*-*-*-*-----*-*-*
-***-***-*****-*****-*****-*********-*******-*********-*****-*-*-*-*-***-*-*-*******-*-***-*-***-*-*******-***-*-*****-***-*
-----*-*---*-*-------------*---*---*-*-------*-*-------*-----*-*---*---*---*---------*-*-*---*-*-*-*-----*-*-------*-*------
-*****-***-*-*-*******-*****-*-*-***-*-*-*****-*-*******-***-***-***-*-***-*-*********-*-***-*-*-*-*-*-***-*-*****-*-*******
-----*---*-*---*-*-----*-----*-*-*---*-*-*-----*-*-------*-*-----*---*---*-*-*-------------*-*---*-*-*-*---*-*---*-*-------*
******-***-*****-*-*****-*****-*-*-***-*-*****-*-*-*******-***-***-*******-*-*-*********-***-***-*****-*-***-*-***-*-*******
---*-------------*-*-----*-*---*-*-*---*-----*---*---*-------*-*-*-----*---*-*-*-------*-*-----*-------*-*---*-*-----*-----*
-***-*************-*****-*-*-***-*-*******-***-***-***-***-***-*-*****-*-*******-*****-*-*-*******-*****-***-*-*-*****-***-*
-*---*-----------------*-*-*-*---*-*-------*---*---*---*-*-*---*-----*-*---------*-*---*-*-*-------*-------*-*-*-*-----*-*-*
**-*-***-*******-*******-*-*-*-*-*-*-*****-*-***-*****-*-*-*-***-***-*-***-***-***-*******-***-*****-*****-*-*-*-*-*-***-*-*
---*---*-*-----*-*-------*-*-*-*-*---*---*-*-*-------*-*---*-*---*---*---*-*-*---------------*-*-----*---*-*-*-*-*-*-*---*-*
**-***-*-***-*-***-*******-*-*-*******-*****-***-***-*-*-***-*-*****-*-*****-*-***************-*-***-***-*-***-***-*-***-***
-*-*-*-*---*-*-------*---*---*---*---------*---*-*-*-*-*-*---*-----*-*-------*-*---*-----------*-*---*-*-----------*---*----
**-*-*-*****-*******-***-***-***-*-*****-*-*-*-***-***-*-***-*-*****-***-*-*****-***-***********-*****-***********-***-*****
---*-*-----------*-*-*-----*---*---*---*-*-*-*---------*---*-*-*---*---*-*-*---------*-----------*-------*-------*-*-------*
**-*-*******-*****-*-*-*****-*-*****-***-***-*****-***-***-*-***-***-***-***-*********-*****-***-*******-*-*****-*-*******-*
-*-*---*---*-*-----*-*-*---*-*-------*---*-----*-*-*---*-*-*-----*---*---*---*-*-------*-----*-*-------*-*-*---*-*-----*---*
-*-***-*-*-***-***-*-*-***-*-***-***-***-*****-*-*-*****-*-***-*****-*-*-*-***-*-***-*****-***-*****-*-*-***-*-*-***-***-***
-*-----*-*-----*-*-*-*---*-*-*-*---*---*-----*-*-*-----*-*---*-------*-*-*-*---*-*-*-*---*-*---*---*-*-*-----*-*---*-*---*--
-*-*****-*******-*-*-*-***-***-***-***-***-*****-*-***-*-***-***-*****-*-*-***-*-*-*-***-***-*-***-***-*-*****-***-*-*-***-*
-*-*---------*---*-*---*---------*-*-*---*-------*-*-*-----*---*-*-----*-*---*---*-*---*-----*---*---*-*-*-*-----*-*-*-*---*
-***-*********-***-*****-*******-*-*-***-***-***-***-*******-*-***-*****-***-*****-*-*-*******-***-***-***-*-*****-***-*-***
-------*-------*-----------*-*---*-----*---*---*-*---------*-*-----*-*-*---*-----*-*-*-----*---*-----------*-*-------*-*---*
**-*****-*******-*****-*****-*-***-***-***-***-***-*****-*******-***-*-*-***-***-*-*-*****-*-***-*********-*-*****-***-*-***
-*-*-*-----*---------*-*-*---*-*---*-*-*-----*-----*---*-------*-----*---*---*-*---*-*-----*-*---*---*-----*-----*-----*-*-*
-*-*-*****-*-*********-*-***-*-*****-***-*****-*****-*-*-***-*******-***-*-***-*****-*******-*****-***-***-*-***-*******-*-*
---*-----*-*-----*---*-*---*-----*-------*-----*-----*-*-*-*-*-----*---*-*-*---*-----*-------------*---*-*-*---*---------*--
-***-*-***-*******-***-*-*-*******-*******-***-*-*****-***-*-*-***-*****-*-***-*-***-*-*****-*****-*****-*-*****-*******-***
-*---*-*-*-------------*-*---------*-------*-*-*---*-*-----*---*-*-------*---*---*-*-*-*---*-*-------*---*-----*---*-*---*-*
**-***-*-*-*********-***-*********-*********-*-***-*-***-*-*****-*********-*-*****-*-*-*-*-*-*-*****-*-*-*****-***-*-*****-*
---*---*---*-------*-*-----*---*-----*-------*---*-*---*-*-----------------*-------*-*-*-*-*-*-*---*-*-*-*-------*---------*
**-*-***-***-*****-*-*-*****-*-*-***-*******-***-***-*-*************-*********-*-***-*-*-*-*-*-***-*-***-***********-*******
-*-*-*---*---*-*-*-*-*---*---*-*-*-*-------*-*-------*---*---------*-*-*-----*-*-*---*-*-*-*-*---*-*---------------*-*-----*
-*-*-*****-***-*-*-*-***-***-***-*-*****-***-*********-***-***-*-***-*-***-*****-*-*****-***-***-*-***************-***-***-*
-*-*-----------*-*-*---*---*-----*-----*---------*---*-*---*-*-*-*---*---*-----*-*-------*-----*-*---------------*-----*-*-*
-*-*************-*-***-*-***-*****-***-*-*******-***-*-*-***-*-*-***-*-*-***-*-*-***-***-*******-*******-*****-*-***-***-***
-*-*-------------*---*-*-*-*-*-------*-*-*-----*-----*-*-*---*-*---*-*-*---*-*-*---*-*-*-*-------------*-*---*-*---*-----*--
**-*-*****-***-*****-*****-*-***-*****-***-***-*****-***-*-*-*-*****-***-*-*-*****-*-*-***-***********-***-***-***-*-***-***
---*-*---*-*-*-----*-----------*-*-*-------*-------*-----*-*-*-*-------*-*-*-------*---*---*-------*-------*---*-*-*-*-*---*
**-*-***-***-***-***-***********-*-***************-*-*****-***-*-*********-*-*****-***-***-***-***-*-*******-***-*-***-***-*
-*-*---*-------*---*-*-----------*-----------*-----*-*-----*---*-----------*-*---*---*---*---*-*-*-*-*-------*-----------*--
-*-***-***-***-***-*-*-*****-*****-*****-***-*****-***-***-***-***********-*-*-*****-***-*-***-*-***-***-*-*************-***
-*---*---*-*-----*---*-*---*-*-----*-----*-*-----*-----*-----*-----------*-*-*-*---*---*-*-*---*-*-----*-*-*-------*-------*
-*******-*-*-***-*-***-*-*-*-***-*****-***-*****-***********-*-*********-*-*-*-***-*-*-*-*-***-*-*-*****-***-*-***-***-***-*
-----*---*-*-*-*-*-*---*-*-*---*-----*-*-------*-------*-*-*-*-*-*-------*-*-*---*-*-*-*-----*-*---*-----*---*-*-*---*-*-*-*
**-***-***-***-*-***-*****-***-*****-*-*-*****-*-*****-*-*-*-*-*-*-*******-***-***-*-*-***-***-*-***-***-*-***-*-*****-*-***
---*---*---*---*-----------*-------*-*-*-*---*-*-*---*---*-*-*-*---*---------*-*---*-*---*-*---*-*---*-*-*-*-*-*-------*----
******-*-***-***-*-*********-*****-***-*-*-*-***-***-*****-*-*-*****-*******-*-*-*-***-*-***-*-***-*-*-***-*-*-*-*****-*****
-------*---*-*-*-*-*-*-------*-*-----*-*-*-*-------*-------*-*-*-----*---*-*---*-*---*-*-----*-----*-*-----*---*-*---*-----*
**-***-***-*-*-*-***-*********-*******-*-***********-*****-*-*-*-*****-***-*****-***-*****-***-*******-*****-***-***-*******
---*-*---*---*-*---*-----------------*-*-------------*-*---*-*-*-------*---------*-*-----*-*-*-------*-*---*-*-----*-------*
-***-***-***-*-***-*******-***-*-***-*-*****-*******-*-*-***-*-*-*******-*****-***-*********-*******-*-*-***-*****-*****-*-*
-*-----*---*-*---*-------*-*-*-*-*-*-*-----*-*-----*-*-*-*---*-*-*---------*---*-------------------*-*-*-------*-*-----*-*-*
-***-*-*-***-*-***-***-*****-***-*-*-*-***-*-*-***-***-*-***-*-***-*********-***-***-*******-*-*****-***-*******-*-*****-***
---*-*---*---*-*---*-*-----*-----*-*---*-*-*-*-*-*---*-*---*-*---------*-----*---*---*-----*-*-*-------*-*---------*-----*--
-*-*******-***-*-***-***-***-*****-*****-*-*-*-*-***-*-*****-*********-*******-***-***-*****-*-*******-*-*****-*****-***-*-*
-*---------*---*-*-----*---*-*-----------*-*---*---*-----------------*-*-------*-*-*-----*---*-------*-*-----*-*-----*-*-*-*
-*********-*-***-*****-***-*-*-***-*-***-***-***-*-*****-*****-*****-*-***-*****-*-*****-*-*****-***-*-*****-*-*****-*-*-***
-*-*-----*-*-*-------*---*-*-*-*-*-*-*-*---*-*---*-----*-*-*-*---*-*-*---*-*-----------*-*-*---*-*-*-*-------*-----*-*-*---*
-*-*-*****-*-*-*****-*-***-*-***-*-***-*-***-*-*******-*-*-*-*****-*-*-***-*-*****-*****-*-*-***-*-***-***-***-***-*-*-***-*
-*-*-*-----*-*---*-*-*-*---*-----*-----*-*---*-------*-*-*-*---------*-*---*-*---*-*-----*---*-*-*-----*-*-*-*-*---*-----*-*
-*-*-*******-*-***-***-***-*-***-*-*****-*-*-*********-*-*-*********-*-*****-***-*-*-***-***-*-*-*******-***-*-*-***-*****-*
---*---------*-*---------*---*-*-*-*-*---*-*---------*-*-*---------*-*-----*---*-*-*-*-----*-*-----*---------*-*-*---*---*-*
**-***-*****-***-*******-*****-***-*-*-***-***-*****-*-*-*-***-***-***-*****-***-***-*****-*-*****-*-*****-*-*-*-*-*****-*-*
-*-*-*-*-*-------------*-----------*-*-*-----*-*-*---*-*-*-*-*---*-----*-----*-------*-*-*-*-*---*-*-*---*-*-*-*-*---*-*---*
**-*-*-*-***-***************-*******-*-*-*****-*-*****-***-*-*****-***-*-***-*-***-*-*-*-*-*-***-***-*-*-*-***-*-***-*-*****
-----*-*---*-*---*---------*-*-----*-*-*-*-----*-----------*-----*---*-*-*-*-*-*-*-*-*-*-*-*---*-----*-*-*-*---*---*-*------
-*****-***-***-***-*****-***-*****-*-*-*-*-*****-*****-*****-***-*****-*-*-*-***-*-***-*-*-*-***-*****-***-*****-***-*******
---*-----*-----*---*---*-*-------*-*---*-*-*-----*---*-*---*-*-*-------*-*-------*-*---*-*-*-*---*-----*---------*---------*
**-*-***-*-***-*****-***-*-*******-***-*-*-***-*****-*-***-*-*-*********-*-*******-***-*-*-*-*-***-***-*****-***-***-*****-*
-*-*-*-*-*-*-*-------*---*---*-------*-*-*---*-------*-*---*-*-----------*-*---*-------*---*---*---*-------*-*-*-*-*---*-*-*
-***-*-*-***-***-*****-*-***-*-*****-*-***-*-*******-***-***-*-*********-*-*-***-*****-*****-***-***-***-***-*-*-*-***-*-***
-----*-*-------*-*-----*---*---*---*-*---*-*-------*-*---*-*-*-*-------*-*-*-----*---*---*---*---*---*-*-*---*-*-*---*-*----
******-*-***-***-***-*****-*****-*****-***-***-*****-***-*-*-*-*******-***-*-*****-*-***-*****-***-***-*-*****-*-***-*-***-*
---*-----*-*-*-----*-----*-----*-------*---*-*-*---------*---*-----*-*---*-*-*-----*---*-------*-*-*---*-------*---*-*---*-*
**-*-*****-***-*-***-***-*-*****-*******-***-*-***-*****-***-*****-*-*-***-*-*****-***-*******-*-***-*-***-*****-***-*-*-***
-*---*---------*-*---*-*-*-*-----*-----------*---*---*-*---*-----*-*-*---*-*-----*---*-------*-*-----*-*---*---------*-*---*
-*****-*********-*-***-*-***-*****-***********-*-*****-***-*****-*-*-***-*-*-***-*-*****-*****-*******-***-*-*********-***-*
---------*-----*-*-*---*-*---*-----*-*-------*-*---------*---*-*-*-----*-*-*-*-*-*-*-*---*-----------*---*-*---*-*-------*-*
**-*******-*****-*-***-*-***-*-*****-***-*****-***-*****-***-*-*-*******-*-***-***-*-*-***-*-***-*****-*-*-***-*-***-*****-*
-*-*-*-------*---*-*---*---*-*-----*---*-*-----*-*-*-*-----*---*---*-----------*---*-*-*---*-*-*-*-----*-*---*-----*-*-*---*
**-*-*-*****-*-*-***-***-***-*****-*-*-*-*-*****-*-*-*****-***-*****-*********-*****-*-***-***-*-***-***-***-***-***-*-*-***
---*-*-*---*-*-*-----*-----*-----*-*-*-*-*-----*-*---*---*---*-----*-*-------*-*-------*-*-*---*---*-*-----*---*-*---*-*-*--
-*-*-*-*-*-*-*******-*****-*****-*-***-*-*-*****-***-***-***-*****-*-*-***-***-*-*****-*-*-***-*-***-*****-*-***-*-***-***-*
-*-*-*-*-*-*-*-------*---*-----*-*-----*-*-*-------*-------*-----*---*---*-*-----*---*---*-*---*-*---*-*-*-*-*---*-*-------*
-***-*****-*-*-*****-***-***-*-*-*******-***-***-***-***********-***-***-*******-***-*****-*-***-*-***-*-*-*-*****-*-*******
-*---------*---*---*-------*-*-*---------------*-*---*-------*-----*-*-*-------*-*-*-------*-*---*-----*-*-*-------*-------*
-*****-*****-***-***********-*-*******-***-*****-*-***-***-***-*****-*-***-*****-*-*******-*-***-***-***-*-***-***-***-***-*
---*---*-*---*---*-----------*-------*-*-*---*-*-*---*-*-*---*-*---------*-*-----*-------*-*---*---*-*---*-*#*---*---*-*-*-*
-***-***-*-***-*-*-***-*************-***-*****-*-***-*-*-***-*-*****-*****-*-*****-***-*-*-***-***-***-***-*-*****-***-*-***
-*---*---*-*---*-*-*-*-----------*-*-*---------*---*-*-*---*-------*-*-----*---*---*-*-*-*-*---*-*-----*---*-----*-*---*----
-*-***-*-*-***-***-*-*******-***-*-***-*******-*-*-*-*-***-*-*******-***-*-***-*****-*-*-*-*-***-*****-*-*-*-***-*-*-*******
---*---*-*---*-*---*-------*-*-*-*-----*-----*-*-*-*-*---*-*-*-------*-*-*---*-------*-*-*---*-------*-*-*-*-*-*---*-------*
****-***-*-*-*-***-*-*****-*-*-*-*****-*****-*-***-*-***-*-***-*******-*-***-*****-*-***-***-*******-*-***-***-***-*******-*
-----*---*-*-*-----*-*-*-*-*-*-*-*---------*-*---*-*-*---*-------------*---*-----*-*---*---*-*-----*-*---*-------*-------*-*
-*******-***-*******-*-*-*-*-*-*-*-*******-*-***-*-*-*-***-***********-***-***-***-*****-***-***-*-*-*-***-*****-*****-***-*
-*-----*---*-----------*-*-*-*-*---*---*---*---*---*-*-*-----*-------*---*-*-*-*---------*-----*-*-*---*---*---*-----*-*---*
******-*****************-*-***-*******-*******-*******-*******-***********-*-*************-*******-*********-*******-*******
